hr黑话
弹性工作制=需要经常加班而且不给加班费，有可能996
抗压能力强=受得了经常加班且不给加班费
工作有激情=受得了经常加班且不给加班费还挺高兴
有责任心=不加班做完不许走
有强烈上进心=做完本职工作后加班去做别人的工作
团队氛围好=大家一起加班
不强制加班=大家都在加班你走一个试试
不提倡加班=该加还是得加班
上不封顶=下不保底
上升空间大=薪资起点低
有期权=画大饼

领导黑话
这个以后再说=这个你别提了
这个建议我会考虑=这个你就别想了
不限预算=我心里没谱儿
性价比要高=我兜里没钱儿
要精致的感觉=抄一下苹果的设计
要尊重用户体验=抄一下同行的做法
要跟上现在的流行大趋势=抄一下大公司的做法
不断试错=在碰一碰运气试试
快速迭代=之前做的不够好
战略调整=老子又想到一个绝妙的点子
向死而生=死定了
启动下一轮融资=快没钱了
做好打硬仗的准备=996或者007加班！

程序员黑话
回去评估一下难度=先拖个几天
重启一下试试=没事别来烦我
这个需求不清晰=不想做
目前技术实现不了=不想做
服务器性能跟不上=不想做
下次肯定不延期了=这次先延期了
这个得走流程=没几个月肯定做不了
已经在做了=还没排到你
是不是你操作问题=我到代码绝对不会有bug！

产品经理黑话
这是最后一次改需求了=先忽悠你改完再说
在？=又要改需求了
这个需求很简单=怎么实现我不管
开发得怎么样了？=怎么还没有做完？
这个最流行的做法=我抄得可好了
这次的产品设计遵循简约的原则=复杂的我也不会
体验不好事技术实现问题=别把锅甩给我
要抓住人性=多放几张美女图

设计师黑话做出个简单的图我看看=先出个炮灰尽快给我=现在立刻马上就要感觉不对=重做你先做=做出来我才知道要不要你觉得这样行吗？=就按照这个抄能不能=改最好=改但是=改如果=改明天一定给你=明天再来催从专业的角度来说...=我不想改别的同事都觉得这样好=我不想改这样呈现的效果比较好=我不想改有设计参考吗？=告诉我去哪里抄运营黑话文案已经快改好了=我憋不出来新用户的获客成本很高=这点预算让我很难做啊爆款可遇不可求=反正跟我无缘曾经打造全网爆款=有幸蹭到一个热点实现了百万级的流量曝光=百度搜索一下有几百万相关内容刷爆朋友圈=刷爆同事的朋友圈今天有什么大事发生吗？=今天有什么热点可以蹭吗？马上出一个致敬海报=马上蹭一个热点
